a b 5 0
a c 10 0
a d 15 5
c e 20 0
c f 5 0
f d 10 0
d g 15 0
e h 10 0
b g 45 0 
